0000000000000000000000000000000000000000000000000000000000000000000000000000000
2100000000000000000000000000000000000000000000000000000000000000000000000000000
0100000000000000000000000000000000000000000000000000000000000000000000000000000
0111111111111111111111111111111111111111111111111111000000000000000000000000000
0100000000000000000000000000000000000000000000000001000000000000000000000000000
0100000000000000000000000000000000000000000000000001000000000000000000000000000
0100000000000000000000000000000000000000000000000001000000000000000000000000000
0100000000000000000000000000000000000000000000000001000000000000000000000000000
0100000000000000000000000000000000000000000000000001100000000000000000000000000
0100000000000000000000000000000000000000000000000000010000000000000000000000000
0100000000000000000000000000000000000000000000000000001100000000000000000000000
0100000000000000000000000000000000000000000000000000000110000000000000000000000
0100000000000000000000000000000000000000000000000000000010000000000000000000000
0100000000000000000000000000000000000000000000000000000010000000000000000000000
0100000000000000000000000000000000000000000000000000000010000000000000000000000
0100000000000000000000000000000000000000000000000000000010000000000000000000000
0100000000000000000000000000000000000000000000000000000010000000000000000000000
0100000000000000000000000000000000000000000000000000000010000000000000000000000
0100000000000000000000000000000000000000000000000000000010000000000000000000000
0100000000000000000000000000000000000000000000000000000010000000000000000000000
0100000000000000000000000000000000000000000000000000000010000000000000000000000
0100000000000000000000000000000000000000000000000000000010000000000000000000000
0111111111111111111111111111111111111111111111111111111111111111111111111111113
0000000000000000000000000000000000000000000000000000000000000000000000000000000
0000000000000000000000000000000000000000000000000000000000000000000000000000000
